Region,30.0 to 34.9 percent,35.0 to 39.9 percent,40.0 to 49.9 percent,50.0 percent or more,Owner Cost Burden
"Abilene, TX Metro Area",1432,970,1586,1511,5499
"Aguadilla, PR Metro Area",978,1003,1337,3056,6374
"Akron, OH Metro Area",6223,4286,4953,9615,25077
"Albany, GA Metro Area",790,672,855,2208,4525
"Albany, OR Metro Area",1954,937,1245,2474,6610
"Albany-Schenectady-Troy, NY Metro Area",8769,5152,7052,11937,32910
"Albuquerque, NM Metro Area",9140,7761,7909,18749,43559
"Alexandria, LA Metro Area",1138,769,746,1631,4284
"Allentown-Bethlehem-Easton, PA-NJ Metro Area",9019,6828,7162,12776,35785
"Altoona, PA Metro Area",763,519,694,1505,3481
"Amarillo, TX Metro Area",2313,1269,1675,3610,8867
"Ames, IA Metro Area",1122,464,574,1172,3332
"Amherst Town-Northampton, MA Metro Area",1706,1490,1602,2520,7318
"Anchorage, AK Metro Area",5404,3279,4051,7097,19831
"Ann Arbor, MI Metro Area",3716,1663,2769,4737,12885
"Anniston-Oxford, AL Metro Area",1035,588,807,1131,3561
"Appleton, WI Metro Area",2293,1185,1535,2595,7608
"Arecibo, PR Metro Area",1374,642,1014,2234,5264
"Asheville, NC Metro Area",3989,2876,2934,6060,15859
"Athens-Clarke County, GA Metro Area",2010,916,1280,2694,6900
"Atlanta-Sandy Springs-Roswell, GA Metro Area",64783,41315,51738,108594,266430
"Atlantic City-Hammonton, NJ Metro Area",5222,3505,4601,9061,22389
"Auburn-Opelika, AL Metro Area",1445,1294,1167,2962,6868
"Augusta-Richmond County, GA-SC Metro Area",5381,2894,3920,8340,20535
"Austin-Round Rock-San Marcos, TX Metro Area",26970,17487,19367,36522,100346
"Bakersfield-Delano, CA Metro Area",8395,6316,8175,16448,39334
"Baltimore-Columbia-Towson, MD Metro Area",34493,21132,23202,50630,129457
"Bangor, ME Metro Area",1169,1079,1062,2286,5596
"Barnstable Town, MA Metro Area",3716,3148,3210,7846,17920
"Baton Rouge, LA Metro Area",6777,5323,6525,12412,31037
"Battle Creek, MI Metro Area",1240,987,1103,2180,5510
"Bay City, MI Metro Area",1334,683,731,1320,4068
"Beaumont-Port Arthur, TX Metro Area",2073,1506,1872,4574,10025
"Beckley, WV Metro Area",521,371,530,1707,3129
"Bellingham, WA Metro Area",3264,2101,2415,5129,12909
"Bend, OR Metro Area",3924,2448,3236,6553,16161
"Billings, MT Metro Area",2105,1231,1328,2982,7646
"Binghamton, NY Metro Area",1691,1525,1569,2747,7532
"Birmingham, AL Metro Area",10598,6398,8107,19234,44337
"Bismarck, ND Metro Area",1322,1222,1019,1484,5047
"Blacksburg-Christiansburg-Radford, VA Metro Area",1038,828,1009,1754,4629
"Bloomington, IL Metro Area",1348,787,1081,1806,5022
"Bloomington, IN Metro Area",1402,830,951,1491,4674
"Boise City, ID Metro Area",9469,7151,7031,12419,36070
"Boston-Cambridge-Newton, MA-NH Metro Area",57291,39943,45783,95607,238624
"Boulder, CO Metro Area",3080,2915,2652,6934,15581
"Bowling Green, KY Metro Area",1051,737,1042,1821,4651
"Bozeman, MT Metro Area",1773,1104,984,2194,6055
"Bremerton-Silverdale-Port Orchard, WA Metro Area",4463,2929,2343,4639,14374
"Bridgeport-Stamford-Danbury, CT Metro Area",10780,8794,9333,24769,53676
"Brownsville-Harlingen, TX Metro Area",2415,1389,2493,3760,10057
"Brunswick-St. Simons, GA Metro Area",872,805,958,2306,4941
"Buffalo-Cheektowaga, NY Metro Area",9457,6602,7211,15458,38728
"Burlington, NC Metro Area",1241,964,1485,1964,5654
"Burlington-South Burlington, VT Metro Area",2720,1718,2283,3861,10582
"Canton-Massillon, OH Metro Area",3690,2439,2534,4720,13383
"Cape Coral-Fort Myers, FL Metro Area",8531,7006,8038,18950,42525
"Cape Girardeau, MO-IL Metro Area",804,427,467,1172,2870
"Carson City, NV Metro Area",736,398,422,1061,2617
"Casper, WY Metro Area",1169,700,725,1365,3959
"Cedar Rapids, IA Metro Area",3301,1788,2054,3668,10811
"Chambersburg, PA Metro Area",2012,1239,922,2339,6512
"Champaign-Urbana, IL Metro Area",1524,1098,1003,2636,6261
"Charleston, WV Metro Area",1478,698,1131,2306,5613
"Charleston-North Charleston, SC Metro Area",8910,5965,6601,16986,38462
"Charlotte-Concord-Gastonia, NC-SC Metro Area",25845,18212,20730,40369,105156
"Charlottesville, VA Metro Area",2808,1120,1486,3553,8967
"Chattanooga, TN-GA Metro Area",4710,2786,4341,7317,19154
"Cheyenne, WY Metro Area",1365,923,1153,1913,5354
"Chicago-Naperville-Elgin, IL-IN Metro Area",105785,70046,83769,175525,435125
"Chico, CA Metro Area",2062,1533,1819,4088,9502
"Cincinnati, OH-KY-IN Metro Area",20751,15114,15301,28987,80153
"Clarksville, TN-KY Metro Area",2987,2401,2114,4721,12223
"Cleveland, OH Metro Area",20415,13345,17131,32687,83578
"Cleveland, TN Metro Area",907,517,567,1944,3935
"Coeur d'Alene, ID Metro Area",2799,1214,2002,3874,9889
"College Station-Bryan, TX Metro Area",1882,1682,1230,3095,7889
"Colorado Springs, CO Metro Area",10779,7711,8541,14999,42030
"Columbia, MO Metro Area",1790,994,885,2287,5956
"Columbia, SC Metro Area",8680,5205,6526,14251,34662
"Columbus, GA-AL Metro Area",2954,2307,1825,5219,12305
"Columbus, IN Metro Area",394,391,450,859,2094
"Columbus, OH Metro Area",19350,12325,15177,26798,73650
"Corpus Christi, TX Metro Area",3437,2650,2948,5857,14892
"Corvallis, OR Metro Area",651,698,743,1238,3330
"Crestview-Fort Walton Beach-Destin, FL Metro Area",3654,2667,2979,5905,15205
"Dallas-Fort Worth-Arlington, TX Metro Area",76837,54098,60019,111265,302219
"Dalton, GA Metro Area",739,851,589,1076,3255
"Daphne-Fairhope-Foley, AL Metro Area",2659,1882,1570,5202,11313
"Davenport-Moline-Rock Island, IA-IL Metro Area",3746,1876,2845,4734,13201
"Dayton-Kettering-Beavercreek, OH Metro Area",7541,4744,5205,9573,27063
"Decatur, AL Metro Area",1196,1034,755,1870,4855
"Decatur, IL Metro Area",888,411,729,1280,3308
"Deltona-Daytona Beach-Ormond Beach, FL Metro Area",8549,7105,7609,16495,39758
"Denver-Aurora-Centennial, CO Metro Area",40895,25847,32321,58349,157412
"Des Moines-West Des Moines, IA Metro Area",7476,5592,5185,9096,27349
"Detroit-Warren-Dearborn, MI Metro Area",43162,26850,33831,71335,175178
"Dothan, AL Metro Area",1354,772,835,2170,5131
"Dover, DE Metro Area",2092,1708,1590,3490,8880
"Dubuque, IA Metro Area",1102,771,753,1326,3952
"Duluth, MN-WI Metro Area",3031,1903,2278,3630,10842
"Durham-Chapel Hill, NC Metro Area",5318,3710,4264,8241,21533
"Eagle Pass, TX Metro Area",302,143,394,674,1513
"Eau Claire, WI Metro Area",1620,1203,1186,1969,5978
"El Centro, CA Metro Area",1182,1107,1173,2686,6148
"Elizabethtown, KY Metro Area",958,771,1080,1440,4249
"Elkhart-Goshen, IN Metro Area",2193,1392,1198,2528,7311
"Elmira, NY Metro Area",645,402,432,1310,2789
"El Paso, TX Metro Area",7488,4720,7199,13157,32564
"Enid, OK Metro Area",489,226,299,657,1671
"Erie, PA Metro Area",2869,1614,1727,3392,9602
"Eugene-Springfield, OR Metro Area",4982,3449,3483,7341,19255
"Evansville, IN Metro Area",2887,1589,1740,3700,9916
"Fairbanks-College, AK Metro Area",928,491,971,1249,3639
"Fargo, ND-MN Metro Area",2137,1301,1794,2440,7672
"Farmington, NM Metro Area",859,506,962,1851,4178
"Fayetteville, NC Metro Area",3445,2423,3324,6969,16161
"Fayetteville-Springdale-Rogers, AR Metro Area",4442,2234,3198,4861,14735
"Flagstaff, AZ Metro Area",1148,661,941,1750,4500
"Flint, MI Metro Area",3949,3270,3128,5885,16232
"Florence, SC Metro Area",1413,1008,1366,2624,6411
"Florence-Muscle Shoals, AL Metro Area",993,675,614,2405,4687
"Fond du Lac, WI Metro Area",979,567,673,895,3114
"Fort Collins-Loveland, CO Metro Area",4358,3815,3731,7647,19551
"Fort Smith, AR-OK Metro Area",1601,618,1249,2887,6355
"Fort Wayne, IN Metro Area",4337,1959,2640,4644,13580
"Fresno, CA Metro Area",11175,7073,8208,19755,46211
"Gadsden, AL Metro Area",569,651,864,1375,3459
"Gainesville, FL Metro Area",2901,1741,2182,4995,11819
"Gainesville, GA Metro Area",1949,1555,1608,2537,7649
"Gettysburg, PA Metro Area",1496,782,1533,1570,5381
"Glens Falls, NY Metro Area",1630,832,1377,1865,5704
"Goldsboro, NC Metro Area",978,530,624,1604,3736
"Grand Forks, ND-MN Metro Area",830,570,837,930,3167
"Grand Island, NE Metro Area",833,309,383,1043,2568
"Grand Junction, CO Metro Area",2614,1612,1673,3897,9796
"Grand Rapids-Wyoming-Kentwood, MI Metro Area",11022,7092,7630,13588,39332
"Grants Pass, OR Metro Area",1407,890,1262,2793,6352
"Great Falls, MT Metro Area",1074,557,706,1304,3641
"Greeley, CO Metro Area",4558,4357,3843,7529,20287
"Green Bay, WI Metro Area",2847,1919,2498,3874,11138
"Greensboro-High Point, NC Metro Area",7002,4850,5537,11078,28467
"Greenville, NC Metro Area",1320,1079,927,1961,5287
"Greenville-Anderson-Greer, SC Metro Area",8190,5424,6190,12805,32609
"Guayama, PR Metro Area",365,157,518,1004,2044
"Gulfport-Biloxi, MS Metro Area",3927,2957,3108,6819,16811
"Hagerstown-Martinsburg, MD-WV Metro Area",2943,2214,2783,4452,12392
"Hammond, LA Metro Area",947,1034,634,1755,4370
"Hanford-Corcoran, CA Metro Area",1255,954,1141,1997,5347
"Harrisburg-Carlisle, PA Metro Area",6617,3720,4996,7708,23041
"Harrisonburg, VA Metro Area",1040,611,638,1132,3421
"Hartford-West Hartford-East Hartford, CT Metro Area",14560,8463,10312,20344,53679
"Hattiesburg, MS Metro Area",1215,1007,795,1810,4827
"Helena, MT Metro Area",1531,927,1185,1563,5206
"Hickory-Lenoir-Morganton, NC Metro Area",3284,1996,2069,4677,12026
"Hilton Head Island-Bluffton-Port Royal, SC Metro Area",3000,2319,2302,5594,13215
"Hinesville, GA Metro Area",742,336,571,1038,2687
"Homosassa Springs, FL Metro Area",1894,1434,1701,3989,9018
"Hot Springs, AR Metro Area",920,520,892,1791,4123
"Houma-Bayou Cane-Thibodaux, LA Metro Area",1781,894,1695,2871,7241
"Houston-Pasadena-The Woodlands, TX Metro Area",60418,43746,52192,106550,262906
"Huntington-Ashland, WV-KY-OH Metro Area",2259,1551,2197,4391,10398
"Huntsville, AL Metro Area",4544,2518,3285,6298,16645
"Idaho Falls, ID Metro Area",1766,1253,1283,2361,6663
"Indianapolis-Carmel-Greenwood, IN Metro Area",20111,12298,14287,27976,74672
"Iowa City, IA Metro Area",1767,851,1261,1946,5825
"Ithaca, NY Metro Area",722,457,516,908,2603
"Jackson, MI Metro Area",1397,1118,920,2370,5805
"Jackson, MS Metro Area",5909,3607,4642,8529,22687
"Jackson, TN Metro Area",1454,710,1290,2498,5952
"Jacksonville, FL Metro Area",17749,11804,14613,29683,73849
"Jacksonville, NC Metro Area",2325,1829,1567,2893,8614
"Janesville-Beloit, WI Metro Area",1625,1153,1201,2108,6087
"Jefferson City, MO Metro Area",1293,637,998,1260,4188
"Johnson City, TN Metro Area",1704,1043,1241,2938,6926
"Johnstown, PA Metro Area",1029,502,698,1206,3435
"Jonesboro, AR Metro Area",602,541,717,1128,2988
"Joplin, MO-KS Metro Area",1580,885,1320,1918,5703
"Kahului-Wailuku, HI Metro Area",2082,1456,1908,4614,10060
"Kalamazoo-Portage, MI Metro Area",2178,1465,1154,3287,8084
"Kankakee, IL Metro Area",1093,610,742,1643,4088
"Kansas City, MO-KS Metro Area",22395,14332,15385,28727,80839
"Kennewick-Richland, WA Metro Area",3321,1954,2133,3301,10709
"Kenosha, WI Metro Area",1912,997,1367,2833,7109
"Killeen-Temple, TX Metro Area",4225,3449,2898,6396,16968
"Kingsport-Bristol, TN-VA Metro Area",2518,1809,2186,4723,11236
"Kingston, NY Metro Area",2496,1473,1662,4026,9657
"Kiryas Joel-Poughkeepsie-Newburgh, NY Metro Area",9501,6000,6868,16652,39021
"Knoxville, TN Metro Area",7838,5867,5919,12161,31785
"Kokomo, IN Metro Area",776,480,665,900,2821
"La Crosse-Onalaska, WI-MN Metro Area",1548,1361,1024,2323,6256
"Lafayette, LA Metro Area",3570,1820,2620,4982,12992
"Lafayette-West Lafayette, IN Metro Area",1958,1007,1224,2164,6353
"Lake Charles, LA Metro Area",1537,1028,1215,3215,6995
"Lake Havasu City-Kingman, AZ Metro Area",2307,1754,2010,5936,12007
"Lakeland-Winter Haven, FL Metro Area",8407,5555,6787,14429,35178
"Lancaster, PA Metro Area",5751,3541,4568,7995,21855
"Lansing-East Lansing, MI Metro Area",5100,2951,3125,6041,17217
"Laredo, TX Metro Area",2418,1157,2305,3545,9425
"Las Cruces, NM Metro Area",2150,1002,1495,3480,8127
"Las Vegas-Henderson-North Las Vegas, NV Metro Area",22871,16070,19613,44738,103292
"Lawrence, KS Metro Area",707,741,724,1022,3194
"Lawton, OK Metro Area",668,654,446,1190,2958
"Lebanon, PA Metro Area",1362,1104,1159,1634,5259
"Lewiston, ID-WA Metro Area",849,269,396,1442,2956
"Lewiston-Auburn, ME Metro Area",1252,1024,869,2113,5258
"Lexington-Fayette, KY Metro Area",4761,3157,3274,5869,17061
"Lexington Park, MD Metro Area",2720,1466,2054,3379,9619
"Lima, OH Metro Area",822,443,653,1025,2943
"Lincoln, NE Metro Area",3489,1830,1999,3646,10964
"Little Rock-North Little Rock-Conway, AR Metro Area",5624,4195,5418,10588,25825
"Logan, UT-ID Metro Area",1238,849,926,1824,4837
"Longview, TX Metro Area",1731,1453,1373,3337,7894
"Longview-Kelso, WA Metro Area",1888,654,1541,2122,6205
"Los Angeles-Long Beach-Anaheim, CA Metro Area",123927,90389,117052,277918,609286
"Louisville/Jefferson County, KY-IN Metro Area",13107,9844,10640,19966,53557
"Lubbock, TX Metro Area",2747,1759,1615,4483,10604
"Lynchburg, VA Metro Area",2378,1501,2085,3019,8983
"Macon-Bibb County, GA Metro Area",1462,996,1989,2654,7101
"Madison, WI Metro Area",7588,5226,5069,8493,26376
"Manchester-Nashua, NH Metro Area",5795,3988,4100,6365,20248
"Manhattan, KS Metro Area",1055,493,662,1341,3551
"Mankato, MN Metro Area",912,788,618,1279,3597
"Mansfield, OH Metro Area",1034,979,694,1180,3887
"Mayagüez, PR Metro Area",1084,956,1015,2181,5236
"McAllen-Edinburg-Mission, TX Metro Area",4647,3293,4786,9615,22341
"Medford, OR Metro Area",3141,2042,2377,3960,11520
"Memphis, TN-MS-AR Metro Area",12341,7476,9417,22013,51247
"Merced, CA Metro Area",2312,1870,2066,4856,11104
"Miami-Fort Lauderdale-West Palm Beach, FL Metro Area",66511,50574,61675,154512,333272
"Michigan City-La Porte, IN Metro Area",931,583,729,1605,3848
"Midland, MI Metro Area",744,502,474,1054,2774
"Midland, TX Metro Area",2261,955,1449,2504,7169
"Milwaukee-Waukesha, WI Metro Area",15664,9631,11968,21439,58702
"Minneapolis-St. Paul-Bloomington, MN-WI Metro Area",45307,26899,30936,56921,160063
"Minot, ND Metro Area",752,613,576,674,2615
"Missoula, MT Metro Area",1404,1018,1347,1876,5645
"Mobile, AL Metro Area",3800,2885,2735,5985,15405
"Modesto, CA Metro Area",5917,4086,4970,10614,25587
"Monroe, LA Metro Area",1541,1119,1061,3072,6793
"Monroe, MI Metro Area",1422,1322,1264,2729,6737
"Montgomery, AL Metro Area",3410,2378,2345,5599,13732
"Morgantown, WV Metro Area",1008,376,635,1217,3236
"Morristown, TN Metro Area",585,520,884,1289,3278
"Mount Vernon-Anacortes, WA Metro Area",2259,1320,1276,2745,7600
"Muncie, IN Metro Area",791,489,447,1421,3148
"Muskegon-Norton Shores, MI Metro Area",1791,1219,1465,2612,7087
"Myrtle Beach-Conway-North Myrtle Beach, SC Metro Area",4198,2724,4171,8314,19407
"Napa, CA Metro Area",1721,1335,1463,3462,7981
"Naples-Marco Island, FL Metro Area",4327,3240,4585,10011,22163
"Nashville-Davidson--Murfreesboro--Franklin, TN Metro Area",23902,14926,16396,32886,88110
"New Haven, CT Metro Area",6416,4902,4307,11183,26808
"New Orleans-Metairie, LA Metro Area",8487,6549,7802,18640,41478
"New York-Newark-Jersey City, NY-NJ Metro Area",183249,128308,163158,392450,867165
"Niles, MI Metro Area",1581,1106,1296,3022,7005
"North Port-Bradenton-Sarasota, FL Metro Area",10770,7271,8663,19419,46123
"Norwich-New London-Willimantic, CT Metro Area",3080,1761,2329,4470,11640
"Ocala, FL Metro Area",4344,2695,3754,7571,18364
"Odessa, TX Metro Area",1576,918,1074,2174,5742
"Ogden, UT Metro Area",8115,4992,5090,7997,26194
"Oklahoma City, OK Metro Area",12754,8506,9615,18492,49367
"Olympia-Lacey-Tumwater, WA Metro Area",4339,2338,3043,5667,15387
"Omaha, NE-IA Metro Area",9960,6079,7074,12777,35890
"Orlando-Kissimmee-Sanford, FL Metro Area",31845,21097,24918,51360,129220
"Oshkosh-Neenah, WI Metro Area",1359,1100,1248,1515,5222
"Owensboro, KY Metro Area",1191,791,665,1357,4004
"Oxnard-Thousand Oaks-Ventura, CA Metro Area",11077,6525,9073,19806,46481
"Paducah, KY-IL Metro Area",627,639,689,1165,3120
"Palm Bay-Melbourne-Titusville, FL Metro Area",7392,4783,6928,14244,33347
"Panama City-Panama City Beach, FL Metro Area",2589,2146,1819,3732,10286
"Parkersburg-Vienna, WV Metro Area",624,637,707,811,2779
"Pensacola-Ferry Pass-Brent, FL Metro Area",5541,3469,4240,9112,22362
"Peoria, IL Metro Area",3913,2174,2508,5440,14035
"Philadelphia-Camden-Wilmington, PA-NJ-DE-MD Metro Area",66124,45126,54316,114402,279968
"Phoenix-Mesa-Chandler, AZ Metro Area",50426,34904,40341,83084,208755
"Pinehurst-Southern Pines, NC Metro Area",1089,834,718,1960,4601
"Pittsburgh, PA Metro Area",22461,13431,15957,30682,82531
"Pittsfield, MA Metro Area",1691,1055,1443,2826,7015
"Pocatello, ID Metro Area",630,521,445,1124,2720
"Ponce, PR Metro Area",1830,1224,1398,3503,7955
"Portland-South Portland, ME Metro Area",7713,4937,6378,11686,30714
"Portland-Vancouver-Hillsboro, OR-WA Metro Area",34529,19785,24694,45545,124553
"Port St. Lucie, FL Metro Area",6490,4527,5813,12931,29761
"Prescott Valley-Prescott, AZ Metro Area",3071,1990,2752,7333,15146
"Providence-Warwick, RI-MA Metro Area",21171,12630,15751,33015,82567
"Provo-Orem-Lehi, UT Metro Area",7533,4213,4624,8151,24521
"Pueblo, CO Metro Area",2114,1303,1773,3846,9036
"Punta Gorda, FL Metro Area",2615,2412,2654,4978,12659
"Racine-Mount Pleasant, WI Metro Area",2537,1672,1698,3446,9353
"Raleigh-Cary, NC Metro Area",13960,9273,9969,21006,54208
"Rapid City, SD Metro Area",2071,1448,1562,2518,7599
"Reading, PA Metro Area",4059,2840,3608,6087,16594
"Redding, CA Metro Area",2225,1306,2116,4298,9945
"Reno, NV Metro Area",6241,4166,4363,9725,24495
"Richmond, VA Metro Area",15218,9969,10840,21802,57829
"Riverside-San Bernardino-Ontario, CA Metro Area",54970,39951,48702,103808,247431
"Roanoke, VA Metro Area",3079,2061,2519,5038,12697
"Rochester, MN Metro Area",2482,1446,1466,2993,8387
"Rochester, NY Metro Area",10614,7537,8489,14734,41374
"Rockford, IL Metro Area",2964,1632,2787,5092,12475
"Rocky Mount, NC Metro Area",1294,749,1094,2082,5219
"Rome, GA Metro Area",662,566,584,899,2711
"Sacramento-Roseville-Folsom, CA Metro Area",30923,20310,24530,48217,123980
"Saginaw, MI Metro Area",1949,858,1285,2189,6281
"St. Cloud, MN Metro Area",1618,1333,1240,2503,6694
"St. George, UT Metro Area",2016,1425,1866,3852,9159
"St. Joseph, MO-KS Metro Area",796,641,519,1438,3394
"St. Louis, MO-IL Metro Area",27943,17761,20750,39780,106234
"Salem, OR Metro Area",5216,3808,3921,7329,20274
"Salinas, CA Metro Area",3510,2991,2859,6805,16165
"Salisbury, MD Metro Area",926,667,1156,1853,4602
"Salt Lake City-Murray, UT Metro Area",13564,9517,10503,17314,50898
"San Angelo, TX Metro Area",958,654,915,1562,4089
"San Antonio-New Braunfels, TX Metro Area",25650,18704,20164,38945,103463
"San Diego-Chula Vista-Carlsbad, CA Metro Area",37971,26817,33832,71518,170138
"Sandusky, OH Metro Area",1044,712,709,1610,4075
"San Francisco-Oakland-Fremont, CA Metro Area",50914,36635,45361,100748,233658
"San Jose-Sunnyvale-Santa Clara, CA Metro Area",20471,13404,15618,33870,83363
"San Juan-Bayamón-Caguas, PR Metro Area",17541,13550,16410,40253,87754
"San Luis Obispo-Paso Robles, CA Metro Area",3865,2767,3164,7272,17068
"Santa Cruz-Watsonville, CA Metro Area",3040,1968,3041,6302,14351
"Santa Fe, NM Metro Area",1784,1166,1774,4153,8877
"Santa Maria-Santa Barbara, CA Metro Area",4309,3246,3572,7768,18895
"Santa Rosa-Petaluma, CA Metro Area",6830,4257,6640,12963,30690
"Savannah, GA Metro Area",4780,2748,3127,7359,18014
"Scranton--Wilkes-Barre, PA Metro Area",4821,2835,4393,8345,20394
"Seattle-Tacoma-Bellevue, WA Metro Area",53284,33446,37537,73574,197841
"Sebastian-Vero Beach-West Vero Corridor, FL Metro Area",2069,1386,1284,3265,8004
"Sebring, FL Metro Area",875,374,682,1674,3605
"Sheboygan, WI Metro Area",1125,943,1073,1304,4445
"Sherman-Denison, TX Metro Area",1331,803,1149,1906,5189
"Shreveport-Bossier City, LA Metro Area",2828,2858,2868,6126,14680
"Sierra Vista-Douglas, AZ Metro Area",1115,470,918,1807,4310
"Sioux City, IA-NE-SD Metro Area",1051,851,787,1889,4578
"Sioux Falls, SD-MN Metro Area",2861,1976,1909,3231,9977
"Slidell-Mandeville-Covington, LA Metro Area",3707,2711,2565,6113,15096
"South Bend-Mishawaka, IN-MI Metro Area",3017,1627,2011,3777,10432
"Spartanburg, SC Metro Area",3333,2005,2820,4419,12577
"Spokane-Spokane Valley, WA Metro Area",7200,4434,5740,9038,26412
"Springfield, IL Metro Area",1713,1211,1401,2834,7159
"Springfield, MA Metro Area",5552,3503,4638,9039,22732
"Springfield, MO Metro Area",5036,2284,3100,6052,16472
"Springfield, OH Metro Area",1250,722,988,1747,4707
"State College, PA Metro Area",1113,1086,1112,1594,4905
"Staunton-Stuarts Draft, VA Metro Area",1118,957,1102,2024,5201
"Stockton-Lodi, CA Metro Area",7952,5908,7390,14703,35953
"Sumter, SC Metro Area",951,793,688,1748,4180
"Syracuse, NY Metro Area",5438,3708,4504,9220,22870
"Tallahassee, FL Metro Area",3479,2061,2306,5251,13097
"Tampa-St. Petersburg-Clearwater, FL Metro Area",36543,25675,31968,65598,159784
"Terre Haute, IN Metro Area",1258,1080,1388,2135,5861
"Texarkana, TX-AR Metro Area",1253,794,887,1653,4587
"Toledo, OH Metro Area",5178,3181,4030,7291,19680
"Topeka, KS Metro Area",2157,1309,1584,2902,7952
"Traverse City, MI Metro Area",2287,1219,1432,2778,7716
"Trenton-Princeton, NJ Metro Area",3624,3107,2887,5839,15457
"Tucson, AZ Metro Area",11367,6937,8788,17569,44661
"Tulsa, OK Metro Area",9319,5465,7142,13105,35031
"Tuscaloosa, AL Metro Area",1928,1155,1451,3864,8398
"Twin Falls, ID Metro Area",1523,1258,893,2154,5828
"Tyler, TX Metro Area",1802,1110,1438,3127,7477
"Urban Honolulu, HI Metro Area",12081,8290,11151,21418,52940
"Utica-Rome, NY Metro Area",2042,1596,2086,3441,9165
"Valdosta, GA Metro Area",1129,903,706,2027,4765
"Vallejo, CA Metro Area",6199,4065,5406,9873,25543
"Victoria, TX Metro Area",632,364,376,929,2301
"Vineland, NJ Metro Area",1743,1634,1557,2951,7885
"Virginia Beach-Chesapeake-Norfolk, VA-NC Metro Area",23172,15438,17394,36670,92674
"Visalia, CA Metro Area",4876,3094,3908,6818,18696
"Waco, TX Metro Area",2213,1472,1993,3387,9065
"Walla Walla, WA Metro Area",612,595,428,681,2316
"Warner Robins, GA Metro Area",1942,1004,1645,2568,7159
"Washington-Arlington-Alexandria, DC-VA-MD-WV Metro Area",75784,49251,52913,107305,285253
"Waterbury-Shelton, CT Metro Area",5227,3242,5462,9450,23381
"Waterloo-Cedar Falls, IA Metro Area",1465,1004,1208,2022,5699
"Watertown-Fort Drum, NY Metro Area",806,488,760,1285,3339
"Wausau, WI Metro Area",1130,682,738,1529,4079
"Weirton-Steubenville, WV-OH Metro Area",676,332,733,1225,2966
"Wenatchee-East Wenatchee, WA Metro Area",1271,597,1015,1576,4459
"Wheeling, WV-OH Metro Area",949,395,957,1312,3613
"Wichita, KS Metro Area",5533,3660,3698,7038,19929
"Wichita Falls, TX Metro Area",951,677,656,1509,3793
"Wildwood-The Villages, FL Metro Area",1552,2012,1352,3123,8039
"Williamsport, PA Metro Area",956,641,798,1556,3951
"Wilmington, NC Metro Area",6038,3333,3926,10405,23702
"Winchester, VA-WV Metro Area",1204,877,1076,1827,4984
"Winston-Salem, NC Metro Area",6045,4013,4821,9540,24419
"Worcester, MA Metro Area",11321,6277,7526,16186,41310
"Yakima, WA Metro Area",2740,1243,1622,2976,8581
"York-Hanover, PA Metro Area",5493,3751,3673,7629,20546
"Youngstown-Warren, OH Metro Area",3091,2544,2347,5879,13861
"Yuba City, CA Metro Area",2384,1308,1774,3439,8905
"Yuma, AZ Metro Area",1826,1279,1484,3512,8101
